あいあい	あひあひ
あいかわらず	あひかはらず
あいすみま	あひすみま
あいた	あいた
あいだ	あひだ
あいまあいま	あひまあひま
あいまが	あひまが
あいまって	あひまつて
あいまに	あひまに
あいまの	あひまの
あい済みま	あひ濟みま
あい乗り	あひ乘り
あい色	あゐ色
あい成	あひ成
あい変わら	あひ變はら
あう	あふ
あえ	あへ
あおい	あをい
あおか	あをか
あおぎ	あふぎ
あおぐ	あふぐ
あおげ	あふげ
あおむ	あふむ
あおり	あふり
あおる	あふる
あがない	あがなひ
あがなう	あがなふ
あがなえ	あがなへ
あがなお	あがなは
あがなわ	あがなは
あげつらい	あげつらひ
あげつらう	あげつらふ
あげつらえ	あげつらへ
あげつらお	あげつらは
あげつらわ	あげつらは
あざない	あざなひ
あざなう	あざなふ
あざなえ	あざなへ
あざなお	あざなは
あざなわ	あざなは
あしらい	あしらひ
あしらう	あしらふ
あしらえ	あしらへ
あしらお	あしらは
あしらわ	あしらは
あじ	あぢ
あじあわ	あぢはは
あじさい	あぢさゐ
あじわい	あぢはひ
あじわう	あぢはふ
あじわえ	あぢはへ
あじわお	あぢはは
あずか	あづか
あずき	あづき
あずけ	あづけ
あずさ	あづさ
あずま	あづま
あそぼう	あそばう
あたえ	あたへ
あつらえ	あつらへ
あてがい	あてがひ
あてがう	あてがふ
あてがえ	あてがへ
あてがお	あてがは
あてがわ	あてがは
あもう	あまう
あやうい	あやふい
あやうう	あやふう
あやうか	あやふか
あやうく	あやふく
あやうけ	あやふけ
あゆもう	あゆまう
あらわ	あらは
ありがとう	ありがたう
ありつい	ありつい
あろう	あらう
あわ	あは
いいなずけ	いいなづけ
いいます	いひます
いう	いふ
いうこともない	いふこともない
いえず	いへず
いえない	いへない
いえば	いへば
いえます	いへます
いえよう	いへやう
いえる	いへる
いえれば	いへれば
いがら	ゑがら
いきおい	いきおひ
いきどお	いきどほ
いきまい	いきまい
いくじ	いくぢ
いけにえ	いけにへ
いさかい	いさかひ
いざない	いざなひ
いざなう	いざなふ
いざなえ	いざなへ
いざなお	いざなは
いざなわ	いざなは
いじけ	いぢけ
いじっ	いぢつ
いじめ	いぢめ
いじら	いぢら
いじり	いぢり
いじる	いぢる
いじれ	いぢれ
いじろ	いぢら
いずこ	いづこ
いずみ	いづみ
いずれ	いづれ
いそしもう	いそしまう
いた	ゐた
いたいけ	いたいけ
いたいまつ	いたいまつ
いたおやか	いたをやか
いたがっ	いたがつ
いたがら	いたがら
いたがり	いたがり
いたがる	いたがる
いたがれば	いたがれば
いたがろう	いたがらう
いたくあん	いたくあん
いたくまし	いたくまし
いたくらみ	いたくらみ
いたくわえ	いたくわへ
いたくわん	いたくわん
いたく感	いたく感
いたく心	いたく心
いたして	いたして
いたしなみ	いたしなみ
いたしまし	いたしまし
いたします	いたします
いたしませ	いたしませ
いたしやし	いたしやし
いたすところ	いたすところ
いたす所	いたす處
いたずら	いたづら
いたせ。	いたせ。
いたたずまい	いたたづまい
いたたみ	いたたみ
いただい	いただい
いただか	いただか
いただき	いただき
いただく	いただく
いただけ	いただけ
いただこ	いただこ
いただなら	いただなら
いたち	いたち
いたちばな	いたちばな
いたちまち	いたちまち
いたった	いたつた
いたっぷり	いたつぷり
いたつまき	いたつまき
いたなぼた	いたなぼた
いたなボタ	いたなボタ
いたぬき	いたぬき
いたのし	いたのし
いたばこ	いたばこ
いたまいて	いたまひて
いたまいま	いたまひま
いたまう	いたまふ
いたまえ、	いたまへ、
いたまえ。	いたまへ。
いたまえば	いたまへば
いたましい	いたましい
いたまな	いたまな
いたまねぎ	いたまねぎ
いたまもの	いたまもの
いたまわず	いたまはず
いたまわぬ	いたまはぬ
いたまわね	いたまはね
いたみ	いたみ
いたみなさん	ゐたみなさん
いたみま	いたみま
いたむ	いたむ
いため、	いため、
いためた	いためた
いためだ	いためだ
いためて	いためて
いためで	いためで
いためでた	ゐためでた
いためな	いためな
いために	いために
いための	いための
いためま	いためま
いためよ	いためよ
いため息	いため息
いたよう	ゐたやう
いたらい	いたらい
いたらこ	いたらこ
いたらない	いたらない
いたらぬ	いたらぬ
いたらばがに	いたらばがに
いたらば蟹	いたらば蟹
いたらふく	いたらふく
いたりま	いたりま
いたる	いたる
いたれり	いたれり
いたわけもの	いたはけもの
いたわけ者	いたはけ者
いたわごと	いたはごと
いたわしい	いたはしい
いたわしう	いたはしう
いたわしく	いたはしく
いたわしゅう	いたはしう
いたわっ	いたはつ
いたわら	いたはら
いたわり	いたはり
いたわりに	ゐたわりに
いたわりには	ゐたわりには
いたわる	いたはる
いたわれ	いたはれ
いたわろ	いたはら
いたわ言	いたは言
いたんこぶ	いたんこぶ
いたんす	いたんす
いたんす、	ゐたんす、
いたんす。	ゐたんす。
いたんぱく	いたんぱく
いたんめん	いたんめん
いたん塩	いたん塩
いたん麺	いたん麺
いたん瘤	いたん瘤
いた皆	ゐた皆
いちゃつい	いちやつい
いつわっ	いつはつ
いつわら	いつはら
いつわり	いつはり
いつわる	いつはる
いつわれ	いつはれ
いつわろ	いつはろ
いて	ゐて
いとおし	いとほし
いとわし	いとはし
いない	ゐない
いなか	ゐなか
いなない	いなない
いにしえ	いにしへ
いのしし	ゐのしし
いば	ゐば
いまし	ゐまし
いましがた	いましがた
いましば	いましば
います	ゐます
いますこし	いますこし
いませ	ゐませ
いまなお	いまなほ
いまわし	いまはし
いる	ゐる
いれば	ゐれば
いわく	いはく
いわず	いはず
いわない	いはない
いわぬ	いはぬ
いわね	いはね
いわば	いはば
いわゆる	いはゆる
いわれる	いはれる
いわん	いはん
ういうい	うひうひ
うえから	うへから
うえない	うゑない
うえに	うへに
うえます	うゑます
うえよ	うゑよ
うえる	うゑる
うえれば	うゑれば
うえろ	うゑろ
うかがい	うかがひ
うかがう	うかがふ
うかがえ	うかがへ
うかがお	うかがは
うかがわ	うかがは
うがい	うがひ
うがとう	うがたう
うぐいす	うぐひす
うごめい	うごめい
うしない	うしなひ
うしなう	うしなふ
うしなえ	うしなへ
うしなお	うしなは
うしなわ	うしなは
うじ	うぢ
うずいた	うづいた
うずいて	うづいて
うずが	うづが
うずく	うづく
うずめ	うづめ
うずもれ	うづもれ
うずら	うづら
うずを	うづを
うそぶい	うそぶい
うたい	うたひ
うたう	うたふ
うたえ	うたへ
うたお	うたは
うたがい	うたがひ
うたがう	うたがふ
うたがえ	うたがへ
うたがお	うたがは
うたがわ	うたがは
うたわ	うたは
うち	うち
うちわ	うちは
うったえ	うつたへ
うつむい	うつむい
うとう	うたう
うともう	うとまう
うなず	うなづ
うなずい	うなづい
うめいた	うめいた
うめいて	うめいて
うめき	うめき
うもう	うまう
うらもう	うらまう
うるう	うるふ
うるおい	うるほひ
うるおう	うるほふ
うるおえ	うるほへ
うるおさ	うるほさ
うるおし	うるほし
うるおす	うるほす
うるおせ	うるほせ
うるおそ	うるほそ
うるおっ	うるほつ
うるおわ	うるほは
うるわし	うるはし
うれえ	うれへ
うろたえ	うろたへ
うろつい	うろつい
うわさ	うはさ
うわず	うはづ
えがいた	ゑがいた
えがいて	ゑがいて
えがかず	ゑがかず
えがかな	ゑがかな
えがき、	ゑがき、
えがきま	ゑがきま
えがく	ゑがく
えがこう	ゑがかう
えくぼ	ゑくぼ
えぐい	ゑぐい
えぐら	ゑぐら
えぐり	ゑぐり
えぐる	ゑぐる
えぐれ	ゑぐれ
えさ	ゑさ
えびす	ゑびす
えらぼう	えらばう
おいさき	おひさき
おいた	おいた
おいて	おいて
おいら	おいら
おうおう	をうをう
おうぎ	あふぎ
おえ	をへ
おお	おほ
おおしい	ををしい
おかさ	をかさ
おかしい	をかしい
おかしう	をかしう
おかしか	をかしか
おかしが	をかしが
おかしく	をかしく
おかしけれ	をかしけれ
おかした	をかした
おかして	をかして
おかしな	をかしな
おかしま	をかしま
おかす	をかす
おかせば	をかせば
おかそう	をかさう
おがみ	をがみ
おがむ	をがむ
おがもう	おがまう
おけら	をけら
おこがま	をこがま
おこない	おこなひ
おこなう	おこなふ
おこなえ	おこなへ
おこなお	おこなは
おこなわ	おこなは
おさな	をさな
おさま	をさま
おさめ	をさめ
おしい	をしい
おしえ	をしへ
おしどり	をしどり
おしむ	をしむ
おじ	をぢ
おじけ	おぢけ
おそい	おそひ
おそう	おそふ
おそえ	おそへ
おそお	おそは
おそわ	おそは
おった	をつた
おって	をつて
おとこ	をとこ
おとずれ	おとづれ
おととい	をととい
おととし	をととし
おとめ	をとめ
おとり	をとり
おとろえ	おとろへ
おどら	をどら
おどり	をどり
おどる	をどる
おどれ	をどれ
おどろう	をどらう
おなご	をなご
おのず	おのづ
おのの	をのの
おののい	をののい
おば	をば
おばか	おばか
おばけ	おばけ
おばんさい	おばんさい
おばんです	おばんです
おぼえ	おぼへ
おみなえし	をみなへし
おめでとう	おめでたう
おもい	おもひ
おもう	おもふ
おもえ	おもへ
おもお	おもほ
おもむい	おもむい
おもわ	おもは
およごう	およがう
おらず	をらず
おらな	をらな
おらぬ	をらぬ
おり	をり
おる	をる
おれざ	をれざ
おれじ	をれじ
おれず	をれず
おれた	をれた
おれて	をれて
おれな	をれな
おれぬ	をれぬ
おれば	をれば
おれま	をれま
おれる	をれる
おれれ	をれれ
おれろ	をれろ
おろう	をらう
おろち	をろち
おわす	おはす
おわっ	をはつ
おわら	をはら
おわり	をはり
おわる	をはる
おわれ	をはれ
おわろ	をはら
おんな	をんな
お目出とう	お目出たう
かいがいし	かひがひし
かいた	かいた
かいて	かいて
かえ	かへ
かえろう	かへらう
かおり	かをり
かおる	かをる
かかえ	かかへ
かかずら	かかづら
かかわ	かかは
かがもう	かがまう
かくまう	かくまふ
かくまえ	かくまへ
かくまおう	かくまはう
かぐわ	かぐは
かけずっ	かけづつ
かけずら	かけづら
かけずり	かけづり
かけずる	かけづる
かけずれ	かけづれ
かけずろ	かけづら
かげろう	かげろふ
かさつい	かさつい
かしず	かしづ
かしずい	かしずい
かじかもう	かじかまう
かすもう	かすまう
かずい	かづい
かせごう	かせがう
かたず	かたづ
かたわ	かたは
かどわか	かどはか
かないと	かないと
かないま	かなひま
かなう	かなふ
かなえ	かなへ
かなお	かなは
かなわ	かなは
かばい	かばひ
かばう	かばふ
かばえ	かばへ
かばお	かばは
かばわ	かばは
かぶりつい	かぶりつい
かまい	かまひ
かまう	かまふ
かまえ	かまへ
かまお	かまは
かまわ	かまは
かみつい	かみつい
かもい	かもゐ
かよい	かよひ
かよう	かよふ
かような	かやうな
かように	かやうに
かよえ	かよへ
かよお	かよは
かよわす	かよはす
かよわせ	かよはせ
かよわそ	かよはさ
からかい	からかひ
からかう	からかふ
からかえ	からかへ
からかおう	からかはう
からかわ	からかは
からみつい	からみつい
からもう	からまう
かろう	からう
かわいい	かはいい
かわうそ	かはうそ
かわさず	かはさず
かわさな	かはさな
かわし	かはし
かわす	かはす
かわず	かはづ
かわせ	かはせ
かわそ	かはそ
かわっ	かはつ
かわや	かはや
かわら	かはら
かわり	かはり
かわる	かはる
かわれ	かはれ
かわろ	かはら
かわろう	かわらう
がえ	がへ
がかない、	がかなひ、
がたつい	がたつい
がっつい	がつつい
がない	がない
がのう	がなう
がよい	がよひ
がらんどう	がらんだう
がろう	がらう
きあい	きあひ
きあう	きあふ
きあえ	きあへ
きあおう	きあはう
きあわ	きあは
きいた	きいた
きいて	きいて
きざもう	きざまう
きずか	きづか
きずが	きづが
きずき	きづき
きずく	きづく
きずけ	きづけ
きずこ	きづか
きずつ	きづつ
きずつい	きづつい
きずは	きづは
きのう	きのふ
きょう	けふ
きらい	きらひ
きらう	きらふ
きらえ	きらへ
きらお	きらは
きらめい	きらめい
きらわ	きらは
きわ	きは
きわめて	きはめて
ぎょう	ぎやう
ぎわ	ぎは
くい込	くひ込
くい止	くひ止
くじい	くじい
くじら	くぢら
くすもう	くすまう
くず	くづ
くだいた	くだいた
くだいて	くだいて
くっつい	くつつい
くつがえ	くつがへ
くもう	くまう
くらい	くらゐ
くらもう	くらまう
くるしもう	くるしまう
くるめい	くるめい
くわえ	くはへ
くわし	くはし
くわす	くはす
くわせ	くはせ
くわそ	くはそ
くわだて	くはだて
くわわ	くはは
ぐあい	ぐあひ
ぐず	ぐづ
ぐずつい	ぐづつい
ぐらい	ぐらい
ぐらつい	ぐらつい
けがらわ	けがらは
けじめ	けぢめ
けずら	けづら
けずり	けづり
けずる	けづる
けずれ	けづれ
けずろ	けづら
けわし	けはし
げじげじ	げぢげぢ
こう	かう
こえない	こへない
こえます	こえます
こえよう	こへやう
こえる	こへる
こえれば	こへれば
こおっ	こほつ
こおり	こほり
こおる	こほる
こおれ	こほれ
こおろ	こほろ
こげつい	こげつい
こごう	こがう
こごもう	こごまう
こしらえ	こしらへ
こずえ	こずゑ
こそごう	こそがう
こたえ	こたへ
こだわら	こだはら
こだわり	こだはり
こだわる	こだはる
こだわれ	こだはれ
こだわろ	こだはら
こづい	こづい
このうえ	このうへ
こびりつい	こびりつい
こまねい	こまねい
こもう	かまう
こらえ	こらへ
ころぼう	ころばう
こわい	こはい
こわば	こはば
こわれ	こはれ
ごう	がう
ございま	ございま
ごたえ	ごたへ
ごたつい	ごたつい
さいた	さいた
さいて	さいて
さいなもう	さいなまう
さいま	さいま
さいわい	さいはひ
さえ	さへ
さけぼう	さけばう
さげすもう	さげすまう
ささやい	ささやい
さざめい	さざめい
さすらい	さすらひ
さすらう	さすらふ
さすらえ	さすらへ
さすらお	さすらは
さすらわ	さすらは
さずか	さづか
さずけ	さづけ
さておい	さておい
さばい	さばい
さびつい	さびつい
さまよい	さまよひ
さまよう	さまよふ
さまよえ	さまよへ
さまよお	さまよは
さまよわ	さまよは
さもう	さまう
さらい	さらひ
さらう	さらふ
さらえ	さらへ
さらお	さらは
さらわ	さらは
さわ	さは
さわが	さわが
さわぎ	さわぎ
さわぐ	さわぐ
さわげ	さわげ
さわごう	さわがう
ざらつい	ざらつい
ざわつい	ざわつい
ざわめい	ざわめい
しいたげ	しひたげ
しいて	しひて
しいる	しひる
しいれば	しひれば
しおらし	しをらし
しおり	しをり
しおれ	しをれ
しがみつい	しがみつい
しごい	しごい
しず	しづ
しずもう	しづまう
しずら	しずら
したがい	したがひ
したがう	したがふ
したがえ	したがへ
したがお	したがは
したがわ	したがは
しのごう	しのがう
しのぼう	しなばう
しばたたい	しばたい
しぶい	しぶい
しまい	しまひ
しまう	しまふ
しまえ	しまへ
しまお	しまは
しまおう	しまはう
しまわ	しまは
しめじ	しめぢ
しゃがもう	しやがまう
しょう	せう
しょぼつい	しよぼつい
しわがれ	しはがれ
しわぶ	しわぶ
じいさん	ぢいさん
じじ	ぢぢ
じゃ	ぢや
じゃま	じやま
すいた	すいた
すいて	すいて
すえ	すゑ
すがりつい	すがりつい
すくい	すくひ
すくう	すくふ
すくえ	すくへ
すくお	すくは
すくわ	すくは
すごもう	すごまう
すじ	すぢ
すすごう	すすがう
すすもう	すすまう
すなお	すなほ
すなわち	すなはち
すわ	すは
ずうずうしい	づうづうしい
ずきずき	づきづき
ずぶ	づぶ
せいた	せいた
せいて	せいて
せがもう	せがまう
せっつい	せつつい
せわし	せはし
ぜいたく	ぜいたく
そーゆー	さういふ
そう	さう
そうろう	さふらう
そこない	そこなひ
そこなう	そこなふ
そこなえ	そこなへ
そこなお	そこなは
そこなわ	そこなは
そそごう	そそがう
そだとう	そだたう
そなえ	そなへ
そのうえ	そのうへ
そむい	そむい
そよごう	そよがう
そろい	そろひ
そろう	そろふ
そろえ	そろへ
そろお	そろは
そろわ	そろは
ぞう	ざう
ぞうきん	ざふきん
たいた	たいた
たいて	たいて
たいら	たひら
たえ	たへ
たおさ	たふさ
たおし	たふし
たおす	たふす
たおせ	たふせ
たおそ	たふそ
たおやか	たをやか
たおれ	たふれ
たくらもう	たくらまう
たくわえ	たくはえ
たぐい	たぐひ
たけなわ	たけなは
たしなもう	たしなまう
たじろ	たぢろ
たずさえ	たづさへ
たずさわ	たづさは
たずね	たづね
たたいた	たたいた
たたいて	たたいて
たたえ	たたへ
たてつい	たてつい
たとう	たたう
たとえ	たとへ
たどりつい	たどりつい
たなびい	たなびい
たのう	たなう
たのしもう	たのしまう
たまい	たまひ
たまう	たまふ
たまえ	たまへ
たまお	たまは
たましい	たましひ
たまわ	たまは
ためらい	ためらひ
ためらう	ためらふ
ためらえ	ためらへ
ためらお	ためらは
ためらわ	ためらは
たもう	たまう
たるもう	たるまう
たろう	たらう
たわけ	たはけ
たわごと	たはごと
たわむれ	たはむれ
たわ言	たは言
だいたい	だいたい
だのう	だなう
だぶつい	だぶつい
だろう	だらう
ちあい	ちあひ
ちいさ	ちひさ
ちがい	ちがひ
ちがいた	ちがいた
ちがう	ちがふ
ちがえ	ちがへ
ちがわず	ちがはず
ちがわない	ちがはない
ちがわぬ	ちがはぬ
ちぢもう	ちぢまう
ちなもう	ちなまう
ちまお	ちまは
ちょー	てう
ちょうさ	ちやうさ
ちょうじ	ちやうじ
ちょうず	てうづ
ちょうだい	ちやうだい
ちょうちょ	てふてふ
ちょうちょう	てふてふ
ちょうちん	ちやうちん
ちょうつがい	てふつがひ
ちょうど	ちやうど
ちょうな	てうな
ちょうら	ちやうら
ちょがら	ちよがら
ちらつい	ちらつい
っ	つ
ついえ	つひえ
ついに	つひに
ついばもう	ついばまう
ついや	つひや
つかい	つかひ
つかう	つかふ
つかえ	つかへ
つかお	つかは
つかもう	つかまう
つかわ	つかは
つがい	つがひ
つがう	つがふ
つがえ	つがへ
つがお	つがは
つがわ	つがは
つごう	つがう
つたい	つたひ
つたう	つたふ
つたえ	つたへ
つたお	つたは
つたわ	つたは
つちかい	つちかひ
つちかう	つちかふ
つちかえ	つちかへ
つちかお	つちかは
つちかわ	つちかは
つつしもう	つつしまう
つづい	つづい
つなごう	つながう
つぶやい	つぶやい
つまずい	つまづい
つまずか	つまづか
つまずき	つまづき
つまずく	つまづく
つまずけ	つまづけ
つまずこ	つまづか
つまもう	つままう
つもう	つまう
つんざい	つんざい
づい	づい
づかい	づかひ
づかもう	づかまう
ていた	てゐた
ていた。	てゐた。
ていただい	ていただい
ていただか	ていただか
ていただき	ていただき
ていただく	ていただく
ていただけた	ていただけた
ていただけて	ていただけて
ていただける	ていただける
ていただけれ	ていただけれ
ていただこう	ていただかう
ていて	てゐて
ていない	てゐない
ていま	てゐま
ていよう	てゐやう
ている	てゐる
ていれ	てゐれ
ており	てをり
てぐすねひい	てぐすねひい
てずから	てづから
てなずけ	てなづけ
てもがい	てもがい
てゆー	ていふ
てらい	てらひ
てらう	てらふ
てらえ	てらへ
てらお	てらは
てらわ	てらは
とうとい	たふとい
とうとう	たうたう
とおらず	とほらず
とおらない	とほらない
とおり	とほり
とおる	とほる
とおれ	とほれ
とかない	とかなひ
ときめい	ときめい
とこしえ	とこしへ
とじ	とぢ
ととのい	ととのひ
ととのう	ととのふ
ととのえ	ととのへ
ととのお	ととのは
ととのわ	ととのは
とどい	とどい
とどろい	とどろい
とぼう	とばう
ともえ	ともゑ
ともない	ともなひ
ともない。	ともない。
ともないか	ともないか
ともないが	ともないが
ともないし	ともないし
ともないだ	ともないだ
ともないで	ともないで
ともないね	ともないね
ともないよ	ともないよ
ともなう	ともなふ
ともなえ	ともなへ
ともなお	ともなは
ともなわ	ともなは
とゆー	といふ
とゆう	といふ
とらえ	とらへ
とりまい	とりまい
どおい	どほい
どおり	どほり
どよめい	どよめい
ないうちに	ないうちに
ないない	ないない
なえ	なへ
なお、	なほ、
なおかつ	なほかつ
なおさ	なほさ
なおさら	なほさら
なおざり	なほざり
なおし	なほし
なおす	なほす
なおせ	なほせ
なおそ	なほそ
なおっ	なおつ
なおっ	なほつ
なおなお	なほなほ
なおのこと	なほのこと
なおの事	なほの事
なおも	なほも
なおもって	なほもつて
なおら	なほら
なおり	なほり
なおる	なほる
なおれ	なほれ
なおろ	なほろ
なかんずく	なかんづく
なごもう	なごまう
なじもう	なじまう
なぞめい	なぞめい
なつい	なつい
なにおい	なにほひ
なびい	なびい
なまめい	なまめい
なめくじ	なめくぢ
なめずり	なめづり
なめずる	なめづる
ならい	ならひ
ならう	ならふ
ならえ	ならへ
ならお	ならは
ならぼう	ならばう
ならわ	ならは
なりわい	なりはい
なんじ	なんぢ
な臭い	な臭ひ
にあい	にあひ
にいたる	にいたる
にいたれ	にいたれ
においが	にほひが
においで	にほひで
におう	にほふ
におお	にほは
におり	にをり
におわ	にほは
におわれ	におわれ
にぎい	にぎひ
にぎう	にぎふ
にぎえ	にぎへ
にぎお	にぎは
にぎわ	にぎは
につい	につい
にない	になひ
になう	になふ
になえ	になへ
になお	になは
になわ	になは
にわか	にはか
にわとり	にはとり
ぬい	ぬひ
ぬいた	ぬいた
ぬいて	ぬいて
ぬう	ぬふ
ぬうち	ぬうち
ぬえ	ぬへ
ぬお	ぬは
ぬぐい	ぬぐひ
ぬぐう	ぬぐふ
ぬぐえ	ぬぐへ
ぬぐお	ぬぐは
ぬぐわ	ぬぐは
ぬごう	ぬがう
ぬすもう	ぬすまう
ぬわ	ぬは
ねあい	ねあひ
ねがい	ねがひ
ねがう	ねがふ
ねがえ	ねがへ
ねがお	ねがは
ねがわ	ねがは
ねぎらい	ねぎらひ
ねぎらう	ねぎらふ
ねぎらえ	ねぎらへ
ねぎらお	ねぎらは
ねぎらわ	ねぎらは
ねじ	ねぢ
ねたもう	ねたまう
ねばつい	ねばつい
ねらい	ねらひ
ねらう	ねらふ
ねらえ	ねらへ
ねらお	ねらは
ねらわ	ねらは
のいたり	のいたり
のうず	のうづ
のせい	のせゐ
のぞい	のぞい
のぞもう	のぞまう
のたまい	のたまひ
のたまう	のたまふ
のたまえ	のたまへ
のたまお	のたまは
のたまわ	のたまは
のにおい	のにほひ
のもう	のまう
のろい	のろひ
のろう	のろふ
のろえ	のろへ
のろお	のろは
のろわ	のろは
の臭い	の臭ひ
はいあが	はひあが
はいつくば	はひつくば
はいのぼ	はひのぼ
はいまわ	はひまわ
はい回	はい囘
はい廻	はひ廻
はい出	はひ出
はい昇	はひ昇
はい上	はひ上
はい登	はひ登
はからい	はからひ
はからう	はからふ
はからえ	はからへ
はからお	はからは
はからわ	はからは
はぐくもう	はぐくまう
はげもう	はげまう
はしゃごう	はしやがう
はじいた	はじいた
はじいて	はじいて
はじいる	はぢいる
はじず	はぢず
はじな	はぢな
はじる	はぢる
はじを	はぢを
はずか	はづか
はずま	はづま
はずみ	はづみ
はずむ	はづむ
はずめ	はづめ
はずもう	はづまう
はずれ	はづれ
はずん	はづん
はたいた	はたいた
はたいて	はたいて
はためい	はためい
はたらい	はたらい
はにかもう	はにかまう
はのう	はなう
はばもう	はばまう
はらい	はらひ
はらう	はらふ
はらえ	はらへ
はらお	はらは
はらもう	はらまう
はらわ	はらは
はりつい	はりつい
ばあい	ばあひ
ばらつい	ばらつい
ばらまい	ばらまい
ぱらい	ぱらひ
ぱらう	ぱらふ
ぱらえ	ぱらへ
ぱらお	ぱらは
ぱらわ	ぱらは
ひいた	ひいた
ひいて	ひいて
ひかえ	ひかへ
ひきい	ひきゐ
ひざまず	ひざまづ
ひざまずい	ひざまづい
ひしめい	ひしめい
ひじ	ひぢ
ひずもう	ひずまう
ひそもう	ひそまう
ひたい	ひたひ
ひっぱたい	ひつぱたい
ひとえ	ひとへ
ひびい	ひびい
ひもとい	ひもとい
ひらめい	ひらめい
ひるがえ	ひるがへ
ひろう	ひろふ
ひろえ	ひろへ
ひろお	ひろは
ひろわ	ひろは
びくつい	びくつい
びろい	びろひ
ふいた	ふいた
ふいて	ふいて
ふくらもう	ふくらまう
ふくろう	ふくろふ
ふさがろう	ふさがらう
ふさわし	ふさはし
ふためい	ふためい
ふぶいた	ふぶいた
ふぶいて	ふぶいて
ふまえ	ふまへ
ふらつい	ふらつい
ふるい	ふるひ
ふるう	ふるふ
ふるえ	ふるへ
ふるお	ふるは
ふるわ	ふるは
ぶとう	ぶたう
ぶらつい	ぶらつい
へつらい	へつらひ
へつらう	へつらふ
へつらえ	へつらへ
へつらお	へつらは
へつらわ	へつらは
へばりつい	へばりつい
べたつい	べたつい
べとつい	べとつい
ほう	はう
ほうけ	ほうけ
ほおずき	ほほづき
ほざい	ほざい
ほっとい	ほつとい
ほどい	ほどい
ほほえま	ほほゑま
ほほえみ	ほほゑみ
ほほえむ	ほほゑむ
ほほえめ	ほほゑめ
ほほえもう	ほほえまう
ほろぼう	ほろばう
ほんとう	ほんたう
ぼもう	ぼまう
ぼやい	ぼやい
まいっ	まゐつ
まいら	まゐら
まいり	まゐり
まいる	まゐる
まいれ	まゐれ
まいろ	まゐら
まうそ	まうそ
まえ	まへ
まかない	まかなひ
まかなう	まかなふ
まかなえ	まかなへ
まかなお	まかなは
まかなわ	まかなは
まがいの	まがひの
まがいもの	まがひもの
まがいモノ	まがひモノ
まがい物	まがひ物
まがう	まがふ
まがえ、	まがへ、
まがえた	まがへた
まがえて	まがへて
まがえる	まがへる
まがおう	まがはう
まがわ	まがは
まぎらわ	まぎらは
まごつい	まごつい
まじえ	まじへ
まじない	まじなひ
まじなう	まじなふ
まじなえ	まじなへ
まじなお	まじなは
まじなわ	まじなは
まじわ	まじは
ますらお	ますらを
まず	まづ
まずに	まずに
またごう	またがう
またたい	またたい
まつわり	まつはり
まつわりつい	まつはりつい
まつわる	まつはる
まとい	まとひ
まとう	まとふ
まとえ	まとへ
まとお	まとは
まとわ	まとは
まどい	まどひ
まどう	まどふ
まどえ	まどへ
まどお	まどは
まどろもう	まどろまう
まどわ	まどは
まなぼう	まなばう
まねい	まねい
まよい	まよひ
まよう	まよふ
まよえ	まよへ
まよお	まよは
まよわ	まよは
まわ	まは
まわり	まはり
まわる	まはる
みあい	みあひ
みえすい	みえすい
みがい	みがい
みさお	みさを
みずから	みづから
みずみず	みづみづ
むいた	むいた
むいて	むいて
むかい	むかひ
むかう	むかふ
むかえ	むかへ
むかお	むかは
むかつい	むかつい
むかわ	むかは
むくい	むくひ
むくう	むくふ
むくえ	むくへ
むくお	むくは
むくわ	むくは
むしばもう	むしばまう
むすぼう	むすばう
むずか	むづか
めいた	めいた
めいて	めいて
めおと	めをと
めずら	めづら
めだとう	めだたう
め立とう	め立たう
もうけ	まうけ
もうし	まうし
もうす	まうす
もうせ	まうせ
もうで	まうで
もう然	まう然
もくろもう	もくろまう
もごう	もがう
もじっ	もぢつ
もじもじ	もぢもぢ
もじり	もぢり
もじる	もぢる
もじれ	もぢれ
もじろう	もぢらう
もたつい	もたつい
もちい	もちゐ
もとい	もとゐ
もとう	もたう
もなお	もなほ
もみじ	もみぢ
もよお	もよほ
もらい	もらひ
もらう	もらふ
もらえ	もらへ
もらお	もらは
もらわ	もらは
ゃ	や
やいた	やいた
やいて	やいて
やしない	やしなひ
やしなう	やしなふ
やしなえ	やしなへ
やしなお	やしなは
やしなわ	やしなは
やしもう	やしまう
やすらい	やすらひ
やすらう	やすらふ
やすらえ	やすらへ
やすらお	やすらは
やすらわ	やすらは
やとい	やとひ
やという	やといふ
やとう	やとふ
やとえ	やとへ
やとお	やとは
やとわ	やとは
やもう	やまう
やろう	やらう
やわじゃ	やはじゃ
やわだ	やはだ
やわな	やはな
やわら	やはら
ゆい	ゆひ
ゆう	ゆふ
ゆえ	ゆゑ
ゆお	ゆは
ゆがもう	ゆがまう
ゆくえ	ゆくへ
ゆずっ	ゆづつ
ゆずら	ゆづら
ゆずり	ゆづり
ゆずる	ゆづる
ゆずれ	ゆづれ
ゆずろう	ゆづらう
ゆらめい	ゆらめい
ゆるごう	ゆるがう
ゆるもう	ゆるまう
ゆわ	ゆは
ゆわえ	ゆはへ
ょ	よ
よう	やう
ようこそ	ようこそ
よこたわ	よこたは
よじ	よぢ
よそおい	よそほひ
よそおう	よそほふ
よそおえ	よそほへ
よそおお	よそほは
よそおわ	よそほは
よのう	よなう
よぼう	よばう
よろこぼう	よろこばう
よろず	よろづ
よろめい	よろめい
らごう	らがう
らわれ	らはれ
りあい	りあひ
りもがい	りもがい
ることもない	ることもない
るにいた	るにいた
れあい	れあひ
れもう	れまう
ろあい	ろあひ
ろう	らう
ろごう	ろがう
わいた	わいた
わいて	わいて
わずか	わづか
わずらい	わづらひ
わずらう	わづらふ
わずらえ	わづらへ
わずらお	わづらは
わずらわ	わづらは
わなない	わなない
わめい	わめい
わらい	わらひ
わらう	わらふ
わらえ	わらへ
わらお	わらは
わらじ	わらぢ
わらわ	わらは
をいた	をいた
をはいた	をはいた
をはいて	をはいて
アー	アァ
アサガオ	アサガホ
アジ	アヂ
アジサイ	アヂサヰ
アズキ	アヅキ
イジメ	イヂメ
イタリア	イタリイ
イナズマ	イナヅマ
イノシシ	ヰノシシ
ウィ	ウヰ
ウィルヘルム	ヴヰルヘルム
ウイ	ウヰ
ウェ	ウヱ
ウェーバー	ヴヱーバー
ウエ	ウヱ
ウエーバー	ヴヱーバー
ウォルフラム	ヴオルフラム
ウオ	ウヲ
ウグイス	ウグヒス
ウジ	ウヂ
ウズラ	ウヅラ
ウワサ	ウハサ
エーション	エイション
エイ	エヒ
エクボ	ヱクボ
エグイ	ヱグイ
エサ	ヱサ
エビス	ヱビス
エンゲージ	エンゲーヂ
オーケストラ	オルケストラ
オケラ	ヲケラ
オコゼ	ヲコゼ
オシドリ	ヲシドリ
オトコ	ヲトコ
オトメ	ヲトメ
オバ	ヲバ
オバケ	オバケ
オリ	ヲリ
オリー	オリー
オリエ	オリエ
オリオ	オリオ
オリガ	オリガ
オリゲ	オリゲ
オリザ	オリザ
オリジ	オリジ
オリッ	オリツ
オリバ	オリバ
オリビ	オリビ
オリン	オリン
オロチ	ヲロチ
オンナ	ヲンナ
カイコ	カヒコ
カエデ	カヘデ
カゲロウ	カゲラフ
カフェ	カフヱ
カムフラージュ	カムフラヂュ
カレー	カリー
カレーター	カレーター
カワイイ	カハイイ
カワウソ	カハウソ
ガレージ	ガレーヂ
キャー	キャア
キュー	キュウ
キョー	キョウ
クエ	クヱ
クジラ	クヂラ
クズ	クヅ
ケーション	ケイション
ケジメ	ケヂメ
ゲーテ	ギヨエテ
ゲジゲジ	ゲヂゲヂ
コート	コオト
コウモリ	カウモリ
コオロギ	コホロギ
コンピュータ	コンピュウタ
コンピューター	コンピュウタ
ゴシック	ゴチック
サービス	サァビス
サファイア	サハイヤ
サファイヤ	サハイヤ
サラリー	サラリィ
シー	シィ
シャー	シャア
シャッター	シャッタア
シュー	シュウ
ショー	ショウ
シンフォ	シンホ
ジー	ヂィ
ジオ	ヂオ
ジジ	ヂヂ
ジャケット	ヂャケツ
ジョーク	ヂョーク
ジレンマ	ディレムマ
スー	スゥ
スー	スウ
スイッチ	スヰツチ
スゥィ	スヰ
スゥイ	スヰ
スゥエット	スヱツト
スウェーデン	スヱーデン
スェット	スヱット
スエーデン	スヱーデン
スエット	スヱット
スター	スタァ
ズキ	ヅキ
ズブ	ヅブ
ズボン	ヅボン
セーター	スヱーター
ゾウ	ザウ
タクシー	タキシィ
ダーウィン	ダアウヰン
チアイ	チアヒ
チェリー	チヱリィ
チェロ	セロ
チガイ	チガヒ
チャー	チャア
チュー	チュウ
チョー	チヤウ
チョウジ	チヤウジ
チョウジャ	チヤウジヤ
チョウセン	テウセン
チョウチョウ	テフテフ
チョウチン	チヤウチン
チョウツガイ	テフツガヒ
チョウナ	テウナ
チョウ詰め	チヤウ詰め
ツイスト	ツヰスト
ツイン	ツヰン
ツェ	ツヱ
テーション	テイション
ティー	ティ
ティーク	チック
ティック	チック
ティング	チング
テライ	テラヒ
データ	デヱタ
ナー	ナァ
ナメクジ	ナメクヂ
ニー	ニィ
ニオい	ニホひ
ニオう	ニホふ
ニオっ	ニホつ
ニオわ	ニホは
ニオイ	ニホヒ
ニュー	ニュウ
ニョー	ニョウ
ニワトリ	ニハトリ
ネジ	ネヂ
ネライ	ネラヒ
ハズ	ハヅ
ハズカ	ハヅカ
ハンカチ	ハンケチ
バー	バァ
バーテン	バァテン
バイオリン	ヴィオロン
パー	パァ
パール	パアル
パライ	パラヒ
ヒジ	ヒヂ
ヒャー	ヒャア
ヒュー	ヒュウ
ヒョー	ヒョオ
ビャー	ビャア
ビュー	ビュウ
ビョー	ビョウ
ピャー	ピャア
ピュー	ピュウ
ピョー	ピョウ
フィリピン	フィリッピン
フクロウ	フクロフ
フジ	フヂ
フルトベングラー	フルトヴヱングラー
ブリッジ	ブリッヂ
ベテラン	ヴェテラン
ベランダ	ヴェランダ
ページ	ペイジ
ホーム	ホオム
ホウキ	ハウキ
ボーイ	ボオイ
ボードレール	ボオドレエル
ボウズ	バウズ
ポーズ	ポーヅ
マジナイ	マジナヒ
マズい	マヅい
マズイ	マヅイ
マニア	マニヤ
マリッジ	マリヱーヂ
ミャー	ミャア
ミュー	ミュウ
ミョー	ミョウ
メール	メイル
モー	モオ
モジモジ	モヂモヂ
モジリ	モヂリ
モミジ	モミヂ
ユーモア	ヒュウモア
ラファエル	ラファヱル
リー	リィ
リュー	リュウ
リョー	リョウ
ルー	ルゥ
レコード	レコオド
ロウソク	ラフソク
ワー	ワァ
ワズライ	ワヅラヒ
ワラジ	ワラヂ
ヴァイオリン	ヴィオロン
亜	亞
哀しもう	哀しまう
愛おし	愛ほし
逢い	逢ひ
逢う	逢ふ
逢え	逢へ
逢わ	逢は
悪	惡
芦	蘆
鯵	鰺
圧	壓
扱い	扱ひ
扱う	扱ふ
扱え	扱へ
扱お	扱ほ
扱わ	扱は
安らい	安らひ
安らう	安らふ
安らえ	安らへ
安らお	安らは
安らわ	安らは
安全弁	安全瓣
暗唱	諳誦
暗夜	闇夜
囲	圍
囲もう	圍まう
意向	意嚮
慰謝料	慰藉料
為	爲
萎もう	萎まう
衣装	衣裳
謂い	謂ひ
謂う	謂ふ
謂え	謂へ
謂お	謂は
謂わ	謂は
違い	違ひ
違う	違ふ
違え	違へ
違おう	違はう
違わ	違は
遺跡	遺蹟
医	醫
育とう	育たう
育もう	育まう
一丁	一挺
一皮むい	一皮むい
壱	壹
稲	稻
引い	引い
引っかい	引つかい
飲	飮
飲もう	飮まう
陰影	陰翳
隠	隱
羽ばたい	羽ばたい
窺い	窺ひ
窺う	窺ふ
窺え	窺へ
窺おう	窺はう
窺わ	窺は
唄い	唄ひ
唄う	唄ふ
唄え	唄へ
唄おう	唄はう
唄わ	唄は
欝	鬱
厩	廏
閏	閠
運ぼう	運ばう
営	營
営もう	營まう
曳	曵
曳い	曵い
栄	榮
永らえ	永らへ
泳い	泳い
泳ごう	泳がう
英才	穎才
英知	叡智
衛	衞
詠もう	詠まう
駅	驛
駅弁	驛辨
悦ぼう	悦ばう
越え	越へ
厭い	厭ひ
厭う	厭ふ
厭え	厭へ
厭おう	厭はう
厭わ	厭は
円	圓
怨もう	怨まう
援護	掩護
沿い	沿ひ
沿う	沿ふ
沿え	沿へ
沿おう	沿はう
沿わ	沿は
煙	烟
艶	艷
艶めい	艷めい
遠のい	遠のい
遠退い	遠退い
塩	鹽
於い	於い
凹もう	凹まう
奥	奧
応	應
応え	應へ
横あい	横あひ
横たわ	横たは
欧	歐
殴	毆
鴬	鶯
黄ばもう	黄ばまう
沖あい	沖あひ
憶説	臆説
憶測	臆測
恩義	恩誼
穏	穩
下克上	下剋上
仮	假
価	價
加え	加へ
夏め	夏め
嫁ごう	嫁がう
歌い	歌ひ
歌う	歌ふ
歌え	歌へ
歌おう	歌はう
歌わ	歌は
火炎	火焔
稼ごう	稼がう
花弁	花瓣
苛もう	苛まう
霞もう	霞まう
画い	畫い
画さ	畫さ
画し	畫し
画す	畫す
画せ	畫せ
画そ	畫さ
画期的	劃期的
画然	劃然
餓え	餓へ
会	會
会い	會ひ
会う	會ふ
会え	會へ
会わ	會は
解い	解い
回	囘
回送	廻送
回虫	蛔蟲
回転	廻転
回復	恢復
回廊	廻廊
壊	壞
壊滅	潰滅
壊乱	潰乱
快活	快濶
怪しもう	怪しまう
懐	懷
懐い	懷い
懐かしもう	懷かしまう
戒告	誡告
皆既食	皆既蝕
絵	繪
開い	開い
外郭	外廓
咳い	咳い
碍	礙
蛎	蠣
鈎	鉤
拡	擴
撹	攪
格闘	挌闘
殻	殼
覚	覺
学	學
学ぼう	學ばう
岳	嶽
楽	樂
楽しもう	樂しまう
額ず	額づ
額ずい	額ずい
割い	割い
活気づい	活氣づい
活発	活溌
渇い	渇い
叶い	叶ひ
叶う	叶ふ
叶え	叶へ
叶おう	叶はう
叶わ	叶は
竃	竈
噛もう	噛まう
粥	鬻
乾い	乾い
乾留	乾溜
勘弁	勘辨
勧	勸
巻	卷
巻い	卷い
喚い	喚い
堪え	堪へ
干害	旱害
干天	害天
患い	患ひ
患う	患ふ
患え	患へ
患おう	患はう
患わ	患は
感づい	感づい
慣わ	慣は
換え	換へ
換わ	換は
敢え	敢へ
歓	歡
歓ぼう	歡ばう
潅	灌
緩もう	緩まう
缶	罐
肝心	肝腎
観	觀
観よう	觀やう
諌	諫
貫い	貫い
間欠	間歇
関	關
関わ	關は
関数	凾数
関連	關聯
陥	陷
含もう	含まう
巌	巖
顔	顏
願い	願ひ
願いはかない	願いはかなひ
願う	願ふ
願え	願へ
願おう	願はう
願わ	願は
企もう	企まう
企画	企劃
喜ぼう	喜ばう
器	噐
基づい	基づい
奇	竒
奇形	畸形
奇跡	奇蹟
奇談	綺談
奇譚	綺譚
寄りつい	寄りつい
希元素	稀元素
希釈	稀釈
希少	稀少
希代	稀代
希薄	稀薄
希硫酸	稀硫酸
期年	朞年
機知	機智
帰	歸
気	氣
気づい	氣づい
気炎	気焔
気色ばもう	氣色ばまう
記章	徽章
貴ぼう	貴ばう
起とう	起たう
輝い	輝い
飢え	飢ゑ
飢餓	饑餓
亀	龜
義援	義捐
偽	僞
戯	戲
技量	技倆
欺い	欺い
犠	犧
疑い	疑ひ
疑う	疑ふ
疑え	疑へ
疑おう	疑はう
疑わ	疑は
掬い	掬ひ
掬う	掬ふ
掬え	掬へ
掬お	掬は
掬わ	掬は
喫水	吃水
却	卻
逆らい	逆らひ
逆らう	逆らふ
逆らえ	逆らへ
逆らおう	逆らはう
逆らわ	逆らは
逆止弁	逆止瓣
休らい	休らひ
休らう	休らふ
休らえ	休らへ
休らおう	休らはう
休らわ	休らは
及ぼう	及ばう
吸い	吸ひ
吸う	吸ふ
吸え	吸へ
吸おう	吸はう
吸わ	吸は
急い	急い
急ごう	急がう
救い	救ひ
救う	救ふ
救え	救へ
救おう	救はう
救わ	救は
汲もう	汲まう
泣い	泣い
泣きつい	泣きつい
糾い	糾ひ
糾う	糾ふ
糾え	糾へ
糾おう	糾はう
糾わ	糾は
糾弾	糺弾
糾明	糺明
給い	給ひ
給う	給ふ
給え	給へ
給おう	給はう
給わ	給は
旧	舊
旧跡	舊蹟
拒もう	拒まう
拠	據
挙	擧
漁労	漁撈
供応	饗応
競い	競ひ
競う	競ふ
競え	競へ
競おう	競はう
競わ	競は
凶悪	兇悪
凶漢	兇漢
凶器	兇器
凶器	兇噐
凶行	兇行
凶手	兇手
凶刃	兇刃
凶変	兇變
凶暴	兇暴
叫ぼう	叫ばう
峡	峽
強固	鞏固
強弁	強辯
恐々	兢々
挟	挾
挟もう	挾まう
教え	教へ
教わ	教は
教戒	教晦
狂い	狂ひ
狂う	狂ふ
狂え	狂へ
狂おう	狂はう
狂おし	狂ほし
狂わ	狂は
狭	狹
興奮	亢奮
響い	響い
驚い	驚い
尭	堯
暁	曉
勤しもう	勤しまう
謹もう	謹まう
近づい	近づい
吟唱	吟誦
区	區
区画	区劃
苦しもう	苦しまう
駆	驅
駆けず	驅けづ
愚図つい	愚圖つい
喰い	喰ひ
喰う	喰ふ
喰え	喰へ
喰おう	喰はう
喰らい	喰らひ
喰らう	喰らふ
喰らえ	喰らへ
喰らお	喰らは
喰らわ	喰らは
喰わ	喰は
空い	空い
屈もう	屈まう
掘削	掘鑿
窪もう	窪まう
勲	勳
薫製	燻製
訓戒	訓誡
係わ	係は
係留	繋留
傾い	傾い
径	徑
恵	惠
慶ぼう	慶ばう
憩	憇
憩い	憇ひ
憩う	憇ふ
憩え	憇へ
憩おう	憇はう
憩わ	憇は
携	攜
携え	攜へ
渓	溪
経	經
経とう	經たう
継	繼
継い	繼い
継ごう	繼がう
繋ごう	繋がう
茎	莖
蛍	螢
計らい	計らひ
計らう	計らふ
計らえ	計らへ
計らおう	計らはう
計らわ	計らは
軽	輕
頚	頸
鶏	鷄
芸	藝
迎え	迎へ
撃とう	撃たう
欠	缺
欠い	缺い
決壊	決潰
決起	蹶起
決別	訣別
結い	結ひ
結う	結ふ
結え	結へ
結お	結は
結びつい	結びつい
結ぼう	結ばう
結わ	結は
月食	月蝕
倹	儉
券	劵
剣	劍
圏	圈
嫌い	嫌ひ
嫌う	嫌ふ
嫌え	嫌へ
嫌おう	嫌はう
嫌わ	嫌は
建とう	建たう
捲い	捲い
検	檢
権	權
牽い	牽い
献	獻
研い	研い
研ごう	研がう
研摩	研磨
県	縣
遣い	遣ひ
遣う	遣ふ
遣え	遣へ
遣おう	遣はう
遣わ	遣は
険	險
顕	顯
顕は	顯は
験	驗
元凶	元兇
厳	嚴
厳然	儼然
弦楽	絃樂
現わ	現は
言い	云ひ
言いおい	云いおい
言い継い	云い繼い
言い置い	云い置い
言う	云ふ
言うこともない	云ふこともない
言え	云へ
言お	云は
言おう	云はう
言っ	云つ
言わ	云は
言祝い	言祝い
古希	古稀
古跡	古蹟
呼ぼう	呼ばう
枯渇	涸渇
跨ごう	跨がう
雇い	雇ひ
雇う	雇ふ
雇え	雇へ
雇おう	雇はう
雇わ	雇は
雇用	雇傭
五弁	五瓣
御者	馭者
語らい	語らひ
語らう	語らふ
語らえ	語らへ
語らおう	語らはう
語らわ	語らは
乞い	乞ひ
乞う	乞ふ
乞え	乞へ
乞おう	乞はう
乞わ	乞は
交い	交ひ
交う	交ふ
交え	交へ
交おう	交はう
交わ	交は
交歓	交驩
交差	交叉
効	效
効い	効い
向い	向い
向かい	向かひ
向かう	向かふ
向かえ	向かへ
向かおう	向かはう
向かわ	向かは
好い	好い
好もう	好まう
幸い	幸ひ
広	廣
広壮	宏壮
広大	宏大
広範	廣汎
広報	弘報
広野	曠野
恒	恆
拘わ	拘は
控え	控へ
控除	扣除
更生	甦生
構い	構ひ
構う	構ふ
構え	構へ
構おう	構はう
構わ	構は
考え	考へ
考えつい	考へつい
肯い	肯ひ
肯う	肯ふ
肯え	肯へ
肯おう	肯はう
肯わ	肯は
行い	行ひ
行う	行ふ
行え	行へ
行おう	行はう
行わ	行は
講和	媾和
貢ごう	貢がう
購い	贖ひ
購う	贖ふ
購え	贖へ
購おう	贖はう
購わ	贖は
鉱	鑛
鉱業	礦業
鉱石	礦石
砿	礦
香典	香奠
高騰	昂騰
高揚	昂揚
号	號
合い	合ひ
合う	合ふ
合え	合へ
合おう	合はう
合わ	合は
轟い	轟い
克とう	克たう
刻もう	刻まう
告ごう	告がう
国	國
漉い	漉い
骨格	骨骼
込もう	込まう
今なお	今なほ
恨もう	恨まう
根づい	根づい
根底	根柢
混もう	混まう
混交	混淆
混迷	昏迷
座っ	坐つ
座ら	坐ら
座り	坐り
座る	坐る
座れ	坐れ
座ろう	坐らう
座客	坐客
座高	坐高
座視	坐視
座州	坐洲
座礁	坐礁
座禅	坐禪
座談	坐談
座標	坐標
座薬	坐薬
挫い	挫い
塞がろう	塞がらう
済	濟
済もう	濟まう
砕	碎
砕い	碎い
斎	齋
裁い	裁い
裁とう	裁たう
剤	劑
咲い	咲い
削ごう	削がう
窄もう	窄まう
桜	櫻
冊	册
擦りむい	擦りむい
雑	雜
雑踏	雑沓
皐	皋
捌い	捌い
錆びつい	錆びつい
三弦	三絃
参	參
惨	慘
撒い	撒い
散蒔い	散蒔い
散水	撒水
散布	撒布
桟	棧
産もう	産まう
産気づい	産氣づい
蚕	蠶
讃	讚
讃え	讚へ
賛	贊
賛辞	讃辭
賛嘆	讃嘆
賛美	讃美
残	殘
残ろう	殘らう
仕え	仕へ
伺い	伺ひ
伺う	伺ふ
伺え	伺へ
伺おう	伺はう
伺わ	伺は
使い	使ひ
使う	使ふ
使え	使へ
使おう	使はう
使わ	使は
刺激	刺戟
史跡	史蹟
嗣ごう	嗣がう
思い	思ひ
思いつい	思ひつい
思う	思ふ
思え	思へ
思おう	思はう
思わ	思は
支え	支へ
止もう	止まう
死のう	死なう
死体	屍躰
死没	死沒
糸	絲
試練	試煉
賜い	賜ひ
賜う	賜ふ
賜え	賜へ
賜おう	賜はう
賜わ	賜は
飼い	飼ひ
飼う	飼ふ
飼え	飼へ
飼おう	飼はう
飼わ	飼は
歯	齒
似つい	似つい
児	兒
慈しもう	慈しまう
持とう	持たう
時めい	時めい
次ごう	次がう
辞	辭
七転八倒	七顛八倒
失い	失ひ
失う	失ふ
失え	失へ
失おう	失はう
失わ	失は
嫉もう	嫉まう
湿	濕
実	實
偲ぼう	偲ばう
写	寫
射幸心	射倖心
車両	車輛
灼い	灼い
酌もう	酌まう
釈	釋
惹い	惹い
取りまい	取りまい
手なずけ	手なづけ
手跡	手蹟
手帳	手帖
首肯い	首肯い
呪い	呪ひ
呪う	呪ふ
呪え	呪へ
呪おう	呪はう
呪わ	呪は
寿	壽
収	收
収集	蒐集
収集	收輯
就い	就い
修練	修煉
愁え	愁へ
拾い	拾ひ
拾う	拾ふ
拾え	拾へ
拾おう	拾はう
拾わ	拾は
秋めい	秋めい
終い	終ひ
終う	終ふ
終え	終へ
終おう	終はう
終わ	終は
終息	終熄
習い	習ひ
習う	習ふ
習え	習へ
習おう	習はう
習は	習は
臭う	臭ふ
臭え	臭へ
臭おう	臭はう
臭わ	臭は
襲い	襲ひ
襲う	襲ふ
襲え	襲へ
襲おう	襲はう
襲わ	襲は
蹴躓い	蹴躓い
集め	輯め
集荷	蒐荷
集成	輯成
集落	聚落
集録	輯録
住まい	住まひ
住まう	住まふ
住まえ	住まへ
住まおう	住まはう
住まわ	住まは
住もう	住まう
従	從
従い	從ひ
従う	從ふ
従え	從へ
従おう	從がふ
従わ	從は
渋	澁
獣	獸
縦	縱
祝い	祝ひ
祝う	祝ふ
祝え	祝へ
祝おう	祝はう
祝わ	祝は
縮もう	縮まう
粛	肅
熟そう	熟さう
俊才	駿才
春めい	春めい
瞬い	瞬い
潤い	潤ひ
潤う	潤ふ
潤え	潤へ
潤おう	潤はう
潤わ	潤は
遵い	遵ひ
遵う	遵ふ
遵え	遵へ
遵おう	遵はう
遵わ	遵は
処	處
書い	書い
書こう	書かう
書簡	書翰
書物	書物
叙	敍
叙情	抒情
鋤い	鋤い
除い	除い
傷ついた	傷ついた
傷ついて	傷ついて
傷もう	傷まう
償い	償ひ
償う	償ふ
償え	償へ
償おう	償はう
償わ	償は
勝とう	勝たう
商い	商ひ
商う	商ふ
商え	商へ
商おう	商はう
商わ	商は
唱い	唱ひ
唱う	唱ふ
唱え	唱へ
唱おう	唱はう
唱わ	唱は
奨	奬
将	將
小突い	小突い
招い	招い
消却	銷却
消沈	銷沈
焼	燒
焼い	燒い
焼きつい	燒きつい
焦げつい	焦げつい
焦燥	焦躁
省い	省い
称	稱
称え	稱へ
称賛	称讚
笑い	笑ひ
笑う	笑ふ
笑え	笑へ
笑おう	笑はう
笑わ	笑は
衝い	衝い
証	證
象眼	象嵌
賞賛	賞讚
障害	障碍
障壁	牆壁
乗	乘
乗ろう	乘らう
剰	剩
壌	壤
嬢	孃
情義	情誼
条	條
浄	淨
畳	疉
穣	穰
蒸留	蒸溜
譲	讓
醸	釀
嘱	囑
拭い	拭ひ
拭う	拭ふ
拭え	拭へ
拭おう	拭はう
拭わ	拭は
植え	植ゑ
色づい	色づい
色めい	色めい
触	觸
食い	食ひ
食いつい	食ひつい
食う	食ふ
食え	食へ
食おう	食はう
食らい	食らひ
食らいつい	食らひつい
食らう	食らふ
食らえ	食らへ
食らおう	食らはう
食らわ	食らは
食わ	食は
食尽	蝕甚
蝕もう	蝕まう
伸長	伸暢
侵食	侵蝕
侵略	侵掠
唇	脣
寝	寢
寝つい	寢つい
心がいた	心がいた
心づい	心づい
慎	愼
慎もう	愼まう
振りまい	振りまい
振るい	振るひ
振るう	振るふ
振るえ	振るへ
振るおう	振るはう
振るわ	振るは
晋	晉
浸い	滲い
浸食	滲蝕
浸透	滲透
真	眞
真跡	真蹟
親しもう	親しまう
進もう	進まう
針術	鍼術
震い	震ひ
震う	震ふ
震え	震へ
震おう	震はう
震わ	震は
刃	刄
尋問	訊問
尽	盡
訊い	訊い
靭	靱
酢酸	醋酸
図	圖
吹い	吹い
吹雪い	吹雪い
垂	埀
炊い	炊い
粋	粹
翠	翆
衰え	衰へ
衰退	衰頽
酔	醉
酔い	醉ひ
酔う	醉ふ
酔え	醉へ
酔おう	醉はう
酔わ	醉は
随	隨
随い	隨ひ
随う	隨ふ
随え	隨へ
随わ	隨は
髄	髓
数	數
数え	數へ
枢	樞
据え	据ゑ
凄もう	凄まう
制御	制禦
勢い	勢ひ
勢いづい	勢ひづい
整い	整ひ
整う	整ふ
整え	整へ
整おう	整はう
整わ	整は
棲もう	棲まう
生い	生ひ
生まれつい	生まれつい
生もう	生まう
生息	棲息
声	聲
誓い	誓ひ
誓う	誓ふ
誓え	誓へ
誓おう	誓はう
誓わ	誓は
請い	請ひ
請う	請ふ
請え	請へ
請おう	請はう
請わ	請は
静	靜
斉	齊
惜しもう	惜しまう
斥い	斥い
積もう	積まう
赤らも	赤らま
接ごう	接がう
摂	攝
窃	竊
窃もう	竊まう
説い	説い
雪ごう	雪がう
絶とう	絶たう
絶賛	絶讚
先ず	先づ
先鋭	尖鋭
先端	尖端
占い	占ひ
占う	占ふ
占え	占へ
占おう	占はう
占わ	占は
宣い	宣ひ
宣う	宣ふ
宣え	宣へ
宣おう	宣はう
宣わ	宣は
専	專
専断	擅断
戦	戰
戦い	戰ひ
戦う	戰ふ
戦え	戰へ
戦おう	戰はう
戦わ	戰は
戦没	戦沒
戦慄い	戰慄い
扇情	煽情
扇動	煽動
撰ぼう	撰ばう
浅	淺
洗い	洗ひ
洗う	洗ふ
洗え	洗へ
洗おう	洗はう
洗わ	洗は
洗浄	洗滌
洗練	洗煉
潜	潛
潜もう	潛まう
穿い	穿い
穿とう	穿たう
線	綫
繊	纖
羨もう	羨まう
船倉	船艙
賎	賤
賎しもう	賤しまう
践	踐
選ぼう	選ばう
選考	銓衡
銭	錢
閃い	閃い
全壊	全潰
禅	禪
繕い	繕ひ
繕う	繕ふ
繕え	繕へ
繕おう	繕はう
繕わ	繕は
措い	措い
曽	曾
狙い	狙ひ
狙う	狙ふ
狙え	狙へ
狙おう	狙はう
狙わ	狙は
疎もう	疎まう
疎水	疏水
疎通	疏通
組みつい	組みつい
組もう	組まう
訴え	訴へ
阻もう	阻まう
阻止	沮止
阻喪	沮喪
双	雙
喪い	喪ひ
喪う	喪ふ
喪え	喪へ
喪おう	喪はう
喪わ	喪は
壮	壯
想い	想ひ
想う	想ふ
想え	想へ
想おう	想はう
想わ	想は
捜	搜
掃い	掃い
掃滅	剿滅
挿	插
挿もう	插まう
掻い	掻い
巣くい	巣くひ
巣くう	巣くふ
巣くえ	巣くへ
巣くおう	巣くはう
巣くわ	巣くは
漕ごう	漕がう
争	爭
争い	爭ひ
争う	爭ふ
争え	爭へ
争おう	爭はう
争わ	爭は
相い	相ひ
相う	相ふ
相え	相へ
相克	相剋
総	總
総合	綜合
総菜	惣菜
聡	聰
荘	莊
装	裝
装い	裝ひ
装う	裝ふ
装え	裝へ
装おう	裝はう
装わ	裝は
装丁	装幀
遭い	遭ひ
遭う	遭ふ
遭え	遭へ
遭わ	遭は
騒	騷
騒ごう	騒がう
憎もう	憎まう
臓	臟
蔵	藏
息づい	息づい
息巻い	息卷い
捉え	捉へ
足掻い	足掻い
属	屬
族生	蔟生
続	續
続い	續い
揃い	揃ひ
揃う	揃ふ
揃え	揃へ
揃おう	揃はう
揃わ	揃は
存え	存へ
尊ぼう	尊ばう
損ない	損なひ
損なう	損なふ
損なえ	損なへ
損なおう	損なはう
損なわ	損なは
多弁	多辯
堕	墮
打とう	打たう
駄弁	駄辯
体	體
対	對
耐え	耐へ
帯	帶
待とう	待たう
戴い	戴い
替え	替へ
替わ	替は
滞	滯
退い	退い
退け	卻け
退色	褪色
退勢	頽勢
退廃	頽廃
退廃	頽廢
代え	代へ
代わ	代は
台	臺
台風	颱風
滝	瀧
啄もう	啄まう
択	擇
拓い	拓い
沢	澤
濯い	濯ひ
濯う	濯ふ
濯え	濯へ
濯おう	濯はう
濯ごう	灌がう
濯わ	濯は
諾い	諾ひ
諾う	諾ふ
諾え	諾へ
諾おう	諾はう
諾わ	諾は
叩い	叩い
達	逹
奪い	奪ひ
奪う	奪ふ
奪え	奪へ
奪おう	奪はう
奪わ	奪は
奪略	奪掠
脱い	脱い
脱ごう	脱がう
竪	豎
狸	貍
単	單
嘆い	嘆い
嘆願	歎願
担	擔
担い	擔ひ
担う	擔ふ
担え	擔へ
担おう	擔はう
担ごう	擔がう
担わ	擔は
湛え	湛え
炭鉱	炭礦
短編	短篇
胆	膽
鍛え	鍛へ
団	團
弾	彈
弾い	彈い
弾もう	彈まう
断	斷
断とう	斷たう
暖房	煖房
暖炉	煖炉
知恵	智慧
知識	智識
知能	智能
知謀	智謀
弛もう	弛まう
恥じ	恥ぢ
恥ず	恥づ
痴	癡
稚	穉
置い	置い
遅	遲
築い	築い
蓄え	蓄へ
着い	着い
昼	晝
注い	注い
注ごう	注がう
注解	註解
注釈	註釈
虫	蟲
鋳	鑄
猪	豬
著わ	著は
貯え	貯へ
丁重	鄭重
凋もう	凋まう
庁	廳
弔い	弔ひ
弔う	弔ふ
弔え	弔へ
弔おう	弔はう
弔わ	弔は
挑もう	挑まう
聴	聽
聴い	聽い
脹らもう	脹らまう
調い	調ひ
調う	調ふ
調え	調へ
調おう	調はう
調わ	調は
調子づい	調子づい
超え	超へ
跳ぼう	跳ばう
長らえ	長らへ
長編	長篇
頂い	頂い
勅	敕
沈もう	沈まう
沈殿	沈澱
鎮	鎭
陳ぼう	陳ばう
追い	追ひ
追いつい	追いつい
追う	追ふ
追え	追へ
追おう	追はう
追わ	追は
痛もう	痛まう
通い	通ひ
通う	通ふ
通え	通へ
通おう	通はう
通わ	通は
掴もう	掴まう
漬い	漬い
壷	壺
停泊	碇泊
抵触	觝触
逓	遞
摘もう	摘まう
適い	適ひ
適う	適ふ
適え	適へ
適おう	適はう
適わ	適は
鉄	鐵
添い	添ひ
添う	添ふ
添え	添へ
添おう	添はう
添わ	添は
纏	纒
纏い	纏ひ
纏う	纏ふ
纏え	纏へ
纏おう	纏はう
纏わ	纏は
転	轉
転ぼう	転ばう
転倒	顛倒
転覆	顛覆
点	點
点い	點い
伝	傳
伝い	傳い
伝う	傳ふ
伝え	傳へ
伝わ	傳は
兎	菟
吐い	吐い
妬い	妬い
妬もう	妬まう
途絶	杜絶
倒壊	倒潰
党	黨
凍てつい	凍てつい
悼もう	悼まう
東京	東亰
盗	盜
盗もう	盗まう
湯がい	湯がい
涛	濤
灯	燈
当	當
答え	答へ
答弁	答辯
討とう	討たう
踏まえ	踏まへ
踏もう	踏まう
踏襲	蹈襲
透い	透い
闘	鬪
闘い	鬪ひ
闘う	鬪ふ
闘え	鬪へ
闘おう	鬪はう
闘わ	鬪は
働い	働い
動い	動い
導い	導い
匿い	匿ひ
匿う	匿ふ
匿え	匿へ
匿おう	匿はう
匿わ	匿は
特集	特輯
毒づい	毒づい
独	獨
読	讀
読もう	讀まう
突い	突い
突っつい	突つつい
届	屆
届い	屆い
呑もう	呑まう
謎めい	謎めい
馴染もう	馴染まう
縄	繩
弐	貳
匂い	匂ひ
匂う	匂ふ
匂え	匂へ
匂おう	匂はう
匂わ	匂は
賑い	賑ひ
賑う	賑ふ
賑え	賑へ
賑おう	賑はう
賑わ	賑は
日食	日蝕
如い	如い
妊	姙
忍ぼう	忍ばう
祢	禰
熱弁	熱辯
粘つい	粘つい
悩	惱
悩もう	惱まう
能弁	能辯
脳	腦
膿もう	膿まう
覗い	覗い
播い	播い
覇	霸
破い	破い
破棄	破毀
破砕	破摧
廃	廢
拝	拜
拝もう	拜まう
背い	背い
背徳	悖徳
培い	培ひ
培う	培ふ
培え	培へ
培おう	培はう
培わ	培は
買い	買ひ
買う	買ふ
買え	買へ
買おう	買はう
買わ	買は
売	賣
這い	這ひ
這い蹲	這ひ蹲
這う	這ふ
這え	這へ
這おう	這はう
這わ	這は
蝿	蠅
矧ごう	矧がう
剥い	剥い
剥ごう	剥がう
白もう	白まう
薄らい	薄らい
薄幸	薄倖
麦	麥
函	凾
肌あい	肌あひ
発	發
発とう	發たう
発酵	醗酵
髪	髮
伐とう	伐たう
抜	拔
抜い	拔い
抜粋	拔萃
伴い	伴ひ
伴う	伴ふ
伴え	伴へ
伴おう	伴はう
伴わ	伴は
反旗	叛旗
反逆	叛逆
反抗	叛抗
反骨	叛骨
反発	反撥
反乱	叛亂
繁殖	蕃殖
煩い	煩ひ
煩う	煩ふ
煩え	煩へ
煩おう	煩はう
煩わ	煩は
挽い	挽い
蛮	蠻
蛮族	蕃族
卑しもう	卑しまう
庇い	庇ひ
庇う	庇ふ
庇え	庇へ
庇おう	庇はう
庇わ	庇は
悲しもう	悲しまう
秘	祕
飛びつい	飛びつい
飛ぼう	飛ばう
飛語	蜚語
微笑もう	微笑まう
微睡もう	微睡まう
筆跡	筆蹟
桧	檜
表わ	表は
描い	描い
病みつい	病みつい
病もう	病まう
病没	病沒
浜	濱
付い	付い
富もう	富まう
布い	布い
敷い	敷い
浮い	浮い
浮かぼう	浮かばう
浮つい	浮つい
符丁	符牒
腐食	腐蝕
腐乱	腐爛
負い	負ひ
負う	負ふ
負え	負へ
負おう	負はう
負わ	負は
赴い	赴い
附い	附い
舞い	舞ひ
舞う	舞ふ
舞え	舞へ
舞おう	舞はう
舞わ	舞は
風刺	諷刺
葺い	葺い
払	拂
払い	拂ひ
払う	拂ふ
払え	拂へ
払おう	拂はう
払わ	拂は
仏	佛
分かとう	分かたう
噴い	噴い
焚い	焚い
奮い	奮ひ
奮う	奮ふ
奮え	奮へ
奮おう	奮はう
奮わ	奮は
紛い	紛ひ
紛う	紛ふ
紛え	紛へ
紛おう	紛はう
紛わ	紛は
聞い	聞い
並	竝
並ぼう	竝ばう
閉じ	閉ぢ
蔑もう	蔑まう
変	變
変え	變へ
変わ	變は
片づい	片づい
編もう	編まう
編集	編輯
辺	邊
辺境	邊疆
弁じ	辯じ
弁ず	辯ず
弁ぜ	辯ぜ
弁解	辯解
弁韓	弁韓
弁慶	辨慶
弁護	辯護
弁告	辨告
弁才	辯才
弁済	辨濟
弁財天	辯財天
弁士	辯士
弁辞	辯辭
弁識	辨識
弁釈	辯釈
弁償	辨償
弁証	辨證
弁舌	辨舌
弁舌	辯舌
弁辰	弁辰
弁天	辯天
弁当	辨當
弁膜	瓣膜
弁明	辯明
弁論	辯論
弁髦	弁髦
弁鰓	瓣鰓
保とう	保たう
保育	哺育
保母	保姆
舗	舖
舗装	鋪装
捕らえ	捕らへ
歩い	歩い
歩もう	歩まう
補い	補ひ
補う	補ふ
補え	補へ
補おう	補はう
補わ	補は
補佐	鋪佐
補導	輔導
穂	穗
慕い	慕ひ
慕う	慕ふ
慕え	慕へ
慕おう	慕はう
慕わ	慕は
暮れなずむ	暮れなづむ
倣い	倣ひ
倣う	倣ふ
倣え	倣へ
倣おう	倣はう
倣わ	倣は
包もう	包まう
包帯	繃帯
包丁	疱丁
宝	寶
崩壊	崩潰
抱い	抱い
抱え	抱へ
抱きつい	抱きつい
放とう	放たう
放棄	抛棄
放物	抛物
縫い	縫ひ
縫う	縫ふ
縫え	縫へ
縫おう	縫はう
縫わ	縫は
萌	萠
褒	襃
豊	豐
飽い	飽い
亡ぼう	亡ばう
妨害	妨碍
暴い	暴い
暴露	曝露
望もう	望まう
冒	冐
膨らもう	膨らまう
膨大	厖大
膨張	膨脹
謀反	謀叛
防ごう	防がう
防御	防禦
没	沒
翻	飜
摩滅	磨滅
磨い	磨い
槙	槇
侭	儘
万	萬
満	滿
味わい	味はひ
味わう	味はう
味わえ	味はへ
味わおう	味ははう
味わっ	味はつ
味わわ	味はは
無知	無智
明い	明い
明らも	明らま
迷い	迷ひ
迷う	迷ふ
迷え	迷へ
迷おう	迷はう
迷わ	迷は
鳴い	鳴い
滅ぼう	滅ばう
綿花	棉花
模さ	摸さ
模し	摸し
模す	摸す
模せ	摸せ
模そ	摸さ
模擬	摸擬
模索	摸索
模造	摸造
模倣	摸倣
盲動	妄動
黙	默
目だとう	目だたう
目論もう	目論まう
餅	餠
貰い	貰ひ
貰う	貰ふ
貰え	貰へ
貰おう	貰はう
貰わ	貰は
問い	問ひ
問う	問ふ
問え	問へ
問おう	問はう
問わ	問は
野卑	野鄙
弥	彌
薬	藥
訳	譯
薮	籔
憂え	憂へ
湧い	湧い
涌い	涌い
誘い	誘ひ
誘う	誘ふ
誘え	誘へ
誘おう	誘はう
誘わ	誘は
遊ぼう	遊ばう
雄弁	雄辯
予	豫
余	餘
与	與
与え	與へ
誉	譽
揺	搖
揺らごう	搖らがう
揺らめい	搖らめい
揺るごう	搖るがう
様	樣
溶い	溶い
溶解	熔解
溶岩	熔岩
溶鉱	鎔鑛
溶接	熔接
用い	用ゐ
耀	燿
謡	謠
謡い	謠ひ
謡う	謠ふ
謡え	謠へ
謡おう	謠はう
謡わ	謠は
遥	遙
養い	養ひ
養う	養ふ
養え	養へ
養おう	養はう
養わ	養は
欲	慾
欲さ	欲さ
欲し	欲し
欲す	欲す
欲せ	欲せ
欲そ	欲さ
欲界	欲界
欲塵	欲塵
欲有	欲有
来	來
頼もう	頼まう
絡みつい	絡みつい
絡もう	絡まう
落盤	落磐
乱	亂
乱獲	濫獲
乱造	濫造
乱読	濫讀
乱発	濫發
乱伐	濫伐
乱用	濫用
覧	覽
利い	利い
利口	悧巧
履い	履い
理屈	理窟
理知	理智
離反	離叛
率い	率ゐ
立ちのい	立ちのい
立とう	立たう
略取	掠取
略奪	掠奪
溜	澑
竜	龍
了解	諒解
了承	諒承
両	兩
両生	兩棲
凌ごう	凌がう
涼もう	涼まう
猟	獵
力もう	力まう
輪郭	輪廓
瑠	璢
塁	壘
涙	泪
涙ぐもう	泪ぐまう
類い	類ひ
例え	例へ
励	勵
励もう	励まう
礼	禮
隷	隸
霊	靈
齢	齡
列ぼう	列ばう
裂い	裂い
恋	戀
恋い	戀ひ
恋う	戀ふ
恋え	戀へ
恋わ	戀は
練炭	煉炭
練乳	煉乳
連関	聯關
連句	聯句
連係	聯繋
連結	聯結
連碁	聯碁
連合	聯合
連鎖	聯鎖
連座	連坐
連珠	聯珠
連想	聯想
連隊	聯隊
連弾	聯弾
連邦	聯邦
連盟	聯盟
連絡	聯絡
連立	聯立
炉	爐
労	勞
労い	勞ひ
労う	勞ふ
労え	勞へ
労おう	勞はう
労わ	勞は
弄ぼう	弄ばう
楼	樓
狼狽え	狼狽へ
篭	籠
老い	老い
禄	祿
和え	和へ
和もう	和まう
歪もう	歪まう
賄い	賄ひ
賄う	賄ふ
賄え	賄へ
賄お	賄は
賄わ	賄は
惑い	惑ひ
惑う	惑ふ
惑え	惑へ
惑お	惑は
惑わ	惑は
亘	亙
湾	灣
湾曲	彎曲
湾入	彎入
伜	倅
俯い	俯い
傅い	傅い
僣	僭
儚もう	儚まう
呟い	呟い
呻い	呻い
咬もう	咬まう
哄い	哄ひ
哄う	哄ふ
哄え	哄へ
哄おう	哄はう
哄わ	哄は
哭い	哭い
啼い	啼い
嗅い	嗅い
嗅ごう	嗅がう
嗜もう	嗜まう
嗤い	嗤ひ
嗤う	嗤ふ
嗤え	嗤へ
嗤おう	嗤はう
嗤わ	嗤は
嘶い	嘶い
嘯い	嘯い
囁い	囁い
夾もう	夾まう
孕もう	孕まう
彷徨い	彷徨ひ
彷徨う	彷徨ふ
彷徨え	彷徨へ
彷徨おう	彷徨はう
彷徨わ	彷徨は
愧じ	愧ぢ
憑い	憑い
懴	懺
拉い	拉い
拱い	拱い
拵え	拵へ
揉もう	揉まう
抬	擡
擲とう	擲たう
攫い	攫ひ
攫う	攫ふ
攫え	攫へ
攫おう	攫はう
攫わ	攫は
晰	皙
昿	曠
曰い	曰ひ
曰う	曰ふ
曰え	曰へ
曰おう	曰はう
曰わ	曰は
曵い	曵い
枡	桝
梳い	梳い
檪	櫟
殱	殲
浚い	浚ひ
浚う	浚ふ
浚え	浚へ
浚おう	浚は
浚わ	浚は
煌めい	煌めい
犇めい	犇めい
狢	貉
獏	貘
珱	瓔
畴	疇
疼い	疼い
眩い	眩い
眩もう	眩まう
睨もう	睨まう
祓らい	祓らひ
祓らう	祓らふ
祓らえ	祓らへ
祓らおう	祓らはう
祓らわ	祓らは
竦もう	竦まう
筝	箏
篩い	篩ひ
篩う	篩ふ
篩え	篩へ
篩おう	篩はう
篩わ	篩は
籖	籤
繙い	繙い
緕	纃
羞じ	羞ぢ
羮	羹
腟	膣
苺	莓
虱	蝨
蠢い	蠢い
衒い	衒ひ
衒う	衒ふ
衒え	衒へ
衒おう	衒はう
衒わ	衒は
訥弁	訥辯
詭弁	詭辯
誂え	誂へ
諍い	諍ひ
諍う	諍ふ
諂い	諂ひ
諂う	諂ふ
諂え	諂へ
諂おう	諂はう
諂わ	諂は
謳い	謳ひ
謳う	謳ふ
謳え	謳へ
謳おう	謳はう
謳わ	謳は
譛	譖
贖い	贖ひ
贖う	贖ふ
贖え	贖へ
贖おう	贖はう
贖わ	贖は
跪い	跪い
蹌踉めい	蹌踉めい
躊躇い	躊躇ひ
躊躇う	躊躇ふ
躊躇え	躊躇へ
躊躇おう	躊躇はう
躊躇わ	躊躇は
躓い	躓い
逎	遒
鈬	鐸
鈩	鑪
鑚	鑽
頌え	頌へ
頷い	頷い
鵞	鵝
鷏	鷆
麸	麩
靡い	靡い
